WiFiManagerOTA	KEYWORD1
MQTTController	KEYWORD1
Logger	KEYWORD1
Statistics	KEYWORD1
TaskScheduler	KEYWORD1
SoftwareWatchdog	KEYWORD1
CircularBuffer	KEYWORD1
LowPassFilter	KEYWORD1
ChangeDetector	KEYWORD1
LEDManager	KEYWORD1
ConfigManager	KEYWORD1
TimeFormatter	KEYWORD1
SerialCommander	KEYWORD1
Buzzer	KEYWORD1
MQTTConfig	KEYWORD2
WiFiConfigStruct	KEYWORD2
WiFiConfig	KEYWORD2
Task	KEYWORD2
Level	KEYWORD2
Pattern	KEYWORD2
bool	KEYWORD2
int	KEYWORD2
String	KEYWORD2
char	KEYWORD2
byte	KEYWORD2
unsigned long	KEYWORD2
uint32_t	KEYWORD2
float	KEYWORD2
size_t	KEYWORD2
begin	KEYWORD2
loop	KEYWORD2
handleWiFiReconnect	KEYWORD2
loadConfig	KEYWORD2
loadMqttConfig	KEYWORD2
saveConfig	KEYWORD2
saveMqttConfig	KEYWORD2
resetConfig	KEYWORD2
connectToWiFi	KEYWORD2
startAccessPoint	KEYWORD2
pubTopic	KEYWORD2
cmdTopic	KEYWORD2
getMqttConfig	KEYWORD2
getWiFiConfig	KEYWORD2
hasValidConfig	KEYWORD2
setLogger	KEYWORD2
mqttCallback	KEYWORD2
publish	KEYWORD2
setPublishTopic	KEYWORD2
setSubscribeTopic	KEYWORD2
setClientId	KEYWORD2
setSecure	KEYWORD2
connectMQTT	KEYWORD2
addValue	KEYWORD2
getMin	KEYWORD2
getMax	KEYWORD2
getAverage	KEYWORD2
getStdDev	KEYWORD2
getCount	KEYWORD2
reset	KEYWORD2
toJSON	KEYWORD2
enable	KEYWORD2
disable	KEYWORD2
feed	KEYWORD2
hasExpired	KEYWORD2
check	KEYWORD2
getTimeSinceLastFeed	KEYWORD2
addTask	KEYWORD2
run	KEYWORD2
setInterval	KEYWORD2
saveString	KEYWORD2
loadString	KEYWORD2
saveInt	KEYWORD2
loadInt	KEYWORD2
saveFloat	KEYWORD2
loadFloat	KEYWORD2
saveBool	KEYWORD2
loadBool	KEYWORD2
clear	KEYWORD2
filter	KEYWORD2
getValue	KEYWORD2
setSmoothingFactor	KEYWORD2
hasChanged	KEYWORD2
getLastValue	KEYWORD2
setThreshold	KEYWORD2
setPattern	KEYWORD2
update	KEYWORD2
formatUptime	KEYWORD2
formatBytes	KEYWORD2
formatRSSI	KEYWORD2
process	KEYWORD2
processCommand	KEYWORD2
setLevel	KEYWORD2
log	KEYWORD2
debug	KEYWORD2
info	KEYWORD2
warning	KEYWORD2
error	KEYWORD2
critical	KEYWORD2
getLevelString	KEYWORD2
